match=eşleştirmek,maç,karşılaştırma,kibrit
whole=tüm,bütün
oriented=odaklı,tabanlı,yönelimli
case=durum,olay
debate=tartışma,tartışmak
syllabus=müfredat,ders programı
advisor=danışman,müşavir
content=içerik,kapsam,tatmin
alright=tamam,iyi
confidence=güven,kendine güven,kendinden emin,inanç
occur=ortaya çıkmak,meydana gelmek,oluşmak
raise=zam,yükselme,yükseltmek,artırmak
trick=kandırmak,hile,oyun etmek,oyuna getirmek,aldatmak,faka basmak,numara,oyun,aldatmaca
fond of=düşkün olmak
express=ifade etmek
suggest=beyan etmek
invalid=geçersiz
initializer=başlatıcı
initialize=başlatmak
appreciated=takdir
appreciate=takdir etmek
provide=sağlamak
present=sunmak
overview=ön izleme
elaborate=özenli
actually=aslında
unload=boşaltmak
abort=iptal etmek
enroll=kaydolmak
enrolling=kayıt
placing=yerleştirme
instructor=eğitmen
instruct=eğitmek
iterate=yinelemek
i got it=anladım
association=dernek
computing=bilgi işlem
mecihanery=makine
ever since=o zamandan beri
since=o zamandan beri
quite=epeyce
that's quite=bu oldukça
evolve=gelişmek
maximize=en üst düzeye çıkarmak
substitute=yerine koymak
to invent=icat etmek
augment=artırmak
orient=yönlendirmek
already=zaten
own=kendi
exactly=tam olarak,kesinlikle
separate=ayırmak,ayrı,müstakil
separator=ayırıcı
conflicting=çelişkili
conflict=çatışma,anlaşmazlık